. . . . . . . . . .
. . . # . # . . # .
. # . # . . . . # .
. # . # . . . # . .
# # . # # # # . . .
# # . # . . . . # .
. . . # . . . . . .
# . # # # # # # # #
. . . . . . . . . .
. . # # # # # # # .