. # # . . . . . # #
. . . . # # # . . .
. # # # # # # # # .
. # # . . . . . # .
. # # . # # # . # .
. . # . # . . . # .
# . # . # # # # # #
# . # . . . . . . .
# . # # # # # # # .
# . . . . . . . . .